2 7 9 3 6 4 5 8 1 
1 3 6 8 5 9 7 4 2 
4 5 8 7 1 2 9 3 6 
7 9 4 6 3 5 1 2 8 
3 8 1 4 2 7 6 9 5 
6 2 5 9 8 1 3 7 4 
5 6 3 2 9 8 4 1 7 
9 4 2 1 7 6 8 5 3 
8 1 7 5 4 3 2 6 9 
